"filename", "language", "Properties", "Markdown", "Rust", "GAS/AT&T x86/x64", "comment", "blank", "total"
"/home/benni/development/os_dev/NextLevelRTOS/README.md", "Markdown", 0, 0, 0, 0, 0, 1, 1
"/home/benni/development/os_dev/NextLevelRTOS/cpu/src/core.rs", "Rust", 0, 0, 25, 0, 6, 3, 34
"/home/benni/development/os_dev/NextLevelRTOS/cpu/src/lib.rs", "Rust", 0, 0, 2, 0, 0, 0, 2
"/home/benni/development/os_dev/NextLevelRTOS/devices/src/bus/mod.rs", "Rust", 0, 0, 1, 0, 0, 0, 1
"/home/benni/development/os_dev/NextLevelRTOS/devices/src/bus/rcc.rs", "Rust", 0, 0, 25, 0, 21, 7, 53
"/home/benni/development/os_dev/NextLevelRTOS/devices/src/controller/dma.rs", "Rust", 0, 0, 103, 0, 5, 23, 131
"/home/benni/development/os_dev/NextLevelRTOS/devices/src/controller/mod.rs", "Rust", 0, 0, 2, 0, 0, 0, 2
"/home/benni/development/os_dev/NextLevelRTOS/devices/src/controller/uart.rs", "Rust", 0, 0, 45, 0, 0, 7, 52
"/home/benni/development/os_dev/NextLevelRTOS/devices/src/generic/cpu.rs", "Rust", 0, 0, 26, 0, 1, 3, 30
"/home/benni/development/os_dev/NextLevelRTOS/devices/src/generic/mod.rs", "Rust", 0, 0, 2, 0, 0, 1, 3
"/home/benni/development/os_dev/NextLevelRTOS/devices/src/generic/platform.rs", "Rust", 0, 0, 74, 0, 1, 7, 82
"/home/benni/development/os_dev/NextLevelRTOS/devices/src/generic/traits.rs", "Rust", 0, 0, 50, 0, 41, 6, 97
"/home/benni/development/os_dev/NextLevelRTOS/devices/src/io/gpio.rs", "Rust", 0, 0, 140, 0, 42, 18, 200
"/home/benni/development/os_dev/NextLevelRTOS/devices/src/io/mod.rs", "Rust", 0, 0, 1, 0, 0, 0, 1
"/home/benni/development/os_dev/NextLevelRTOS/devices/src/lib.rs", "Rust", 0, 0, 7, 0, 0, 2, 9
"/home/benni/development/os_dev/NextLevelRTOS/devices/src/registerblocks/dma.rs", "Rust", 0, 0, 29, 0, 10, 4, 43
"/home/benni/development/os_dev/NextLevelRTOS/devices/src/registerblocks/gpio.rs", "Rust", 0, 0, 19, 0, 16, 2, 37
"/home/benni/development/os_dev/NextLevelRTOS/devices/src/registerblocks/mod.rs", "Rust", 0, 0, 4, 0, 0, 0, 4
"/home/benni/development/os_dev/NextLevelRTOS/devices/src/registerblocks/rcc.rs", "Rust", 0, 0, 21, 0, 16, 4, 41
"/home/benni/development/os_dev/NextLevelRTOS/devices/src/registerblocks/usart.rs", "Rust", 0, 0, 19, 0, 10, 1, 30
"/home/benni/development/os_dev/NextLevelRTOS/documentation/part1_boot_procedure.md", "Markdown", 0, 285, 0, 0, 0, 132, 417
"/home/benni/development/os_dev/NextLevelRTOS/documentation/part2_device_access_en.md", "Markdown", 0, 12, 0, 0, 0, 5, 17
"/home/benni/development/os_dev/NextLevelRTOS/documentation/part2_device_access_ru.md", "Markdown", 0, 14, 0, 0, 0, 8, 22
"/home/benni/development/os_dev/NextLevelRTOS/kernel/openocd.cfg", "Properties", 2, 0, 0, 0, 3, 2, 7
"/home/benni/development/os_dev/NextLevelRTOS/kernel/src/asm/context_mng.s", "GAS/AT&T x86/x64", 0, 0, 0, 21, 0, 4, 25
"/home/benni/development/os_dev/NextLevelRTOS/kernel/src/data/list.rs", "Rust", 0, 0, 62, 0, 6, 6, 74
"/home/benni/development/os_dev/NextLevelRTOS/kernel/src/data/mod.rs", "Rust", 0, 0, 1, 0, 0, 0, 1
"/home/benni/development/os_dev/NextLevelRTOS/kernel/src/main.rs", "Rust", 0, 0, 53, 0, 14, 13, 80
"/home/benni/development/os_dev/NextLevelRTOS/kernel/src/mem/malloc.rs", "Rust", 0, 0, 13, 0, 2, 4, 19
"/home/benni/development/os_dev/NextLevelRTOS/kernel/src/mem/mod.rs", "Rust", 0, 0, 1, 0, 0, 0, 1
"/home/benni/development/os_dev/NextLevelRTOS/kernel/src/proc/mod.rs", "Rust", 0, 0, 3, 0, 0, 0, 3
"/home/benni/development/os_dev/NextLevelRTOS/kernel/src/proc/sched.rs", "Rust", 0, 0, 31, 0, 23, 8, 62
"/home/benni/development/os_dev/NextLevelRTOS/kernel/src/proc/task.rs", "Rust", 0, 0, 6, 0, 21, 5, 32
"/home/benni/development/os_dev/NextLevelRTOS/kernel/src/proc/tcb.rs", "Rust", 0, 0, 25, 0, 19, 9, 53
"/home/benni/development/os_dev/NextLevelRTOS/process/src/blueprint.rs", "Rust", 0, 0, 37, 0, 8, 8, 53
"/home/benni/development/os_dev/NextLevelRTOS/process/src/lib.rs", "Rust", 0, 0, 15, 0, 0, 2, 17
"/home/benni/development/os_dev/NextLevelRTOS/runtime/build.rs", "Rust", 0, 0, 10, 0, 4, 4, 18
"/home/benni/development/os_dev/NextLevelRTOS/runtime/src/lib.rs", "Rust", 0, 0, 62, 0, 18, 15, 95
"Total", "-", 2, 311, 914, 21, 287, 314, 1849